11111111111111111111
1P0000000000000000E1
11110111111111111011
1C0000000000000000C1
10111111111111111101
10000000000000000001
10111111111111111011
1C0000000000000000C1
11110111111111111111
11111111111111111111