111111111111111111111111111111111111111111111111111111111111
1P0000110000000000000000000000000000000000000000000000000011
1000100E0000000000000000000000000000000000000000000000000011
101C10110000000000000000000000000000000000000000000000000011
111111111111111111111111111111111111111111111111111111111111
