1111111111
1P00000C11
1000010E01
1000000001
1111111111