1111111111
1P000000C1
1011111101
1C00000001
1011111101
1C00000001
1011111101
1000000EC1
1111111111