1111111111
1P000000C1
1011111101
1C00000001
1011111101
1C00000001
1011111101
10000000E1
1111111111