11111111111111111111
1P0000000000000000E1
10111111111111111101
1C0000000000000000C1
10111111111111111101
10000000000000000001
10111111111111111101
1C0000000000000000C1
10111111111111111101
11111111111111111111